5 3 2
10
0 0 0 0 1
0 1 0 0 1
1 0 0 1 0
1 2 0 0 1
2 0 0 1 1
2 1 0 0 1
3 0 0 1 0
3 2 0 1 1
4 0 0 1 0
4 1 0 1 0
2
1 1 2
3 1 1